################################D########################                       
#.......................................................#                       
#.......................................................#                       
#.......................................................#                       
###############################   #######################                       
                              #   #                                             
                              #   #                                             
                              #   #                                             
#x#############################   ############################################x#
#....b.........................................................................#
#....b.......b.................................................................#
#..............................................................................#####################################################################
#....b....S....................................................................                                                                    #
#.r..............b.............................................................                                                                    #
#..............................................................................#####################################################################
#......................................................                        #
D..................v...................................                        #
#....b................................................. x|         |           #
#......................................................  |         |           #
#......................................................  |         |           #
#........vb............................................  |    b    |           #
#.................x....................................  |    .... |           #
#......................................................  |b   .... |xz         #
#......................................................                        #
#......................................................                        #
#......................................................                        #
#......................................................                        #
zy############################################################################yz
